Mountains
....................................................................................
....................................................................................
....................................................................................
.............................................W................WW....................
.............................................WZ...............WW....................
.............................................WWWWW............WW....C...............
.................................................W....WWWWW...69...WWW..............
.................................z...............W....W...W........W.W..............
................................WWWRr............W....W...W.......WW.W..............
...................................##Rr.......M..WbbbbW...WWWWWWWWWW.W..............
......ooo....ff...........................lL#.....ooooW..............W..............
.S..lL###Rr......C....P..H.e..s.........lL###.....ooooW..............W.........E....
#############AA##################...OOO#############################################
#################################......#############################################

LEGENDE :
  [.] = case vide
  [S] = point de départ du monde
  [F] = Arrivee
  [#] = sol
  [W] = bloc (buche de bois)
  [=] = bloc one-way
  [o] = pièce (luciolle)
  [e] = ennemi (noisette magique)
  [A] = ennemi statique (pique)