................................................................................................................................
................................................................................................................................
................................................................................................................................
................................................................................................................................
...................................................................................W............................................
................oooo...............................................................W............................................
...............o....o..............................................................W............................................
..............o......oooo..........................................................B............................................
.......b.....oW.....======....................................................W....W....W.......................................
............oWW.M............................................................WW.........W.......................................
...........oWWW.............................................................WWW.........W.......................................
.S....B..o.WWWW....lL####Rr.........e...e...e....................E.........WWWW.........W...........................F...........
#################################################AAAWAAAWAAA####################################################################
################################################################################################################################

LEGENDE :
  [.] = case vide
  [S] = point de départ du monde
  [F] = Arrivee
  [#] = sol
  [W] = bloc (buche de bois)
  [=] = bloc one-way
  [o] = pièce (luciolle)
  [e] = ennemi (noisette magique)
  [A] = ennemi statique (pique)