...............................................................................
...............................................................................
...............................................................................
.........................................................WW....................
.........................................................WW....................
............................................W............WW....................
............................................W....WWWWW...69....WW..............
............................................W....W...W.........WW..............
............................................W....W...W........WWW..............
....................................M.......W....W...WWWWWWWWWW.W..............
......ooo....................................ooooW..............W..............
.S..lL###Rr....C.........H.e..s..............ooooW..............W.........E....
#############AA################################################################
###############################################################################

LEGENDE :
  [.] = case vide
  [S] = point de départ du monde
  [F] = Arrivee
  [#] = sol
  [W] = bloc (buche de bois)
  [=] = bloc one-way
  [o] = pièce (luciolle)
  [e] = ennemi (noisette magique)
  [A] = ennemi statique (pique)